1111111111111111111
1000010101010100001
1000010101010100001
1000010000000100001
1000010000000100001
1000010000000100001
1000011110111100001
1000000000000000001
1000000000000000001
1000005550000000001
1000055555000000001
1001111511111111111
1111555555555555551
5555555555555555551
5555555555555555551
1111555555555555551
1000111111511111111
1000000555555500001
1000000055555000001
1111111111111111111
0
6
1 1 3 1
17 1 3 1
6 1 7 1
8 1 6 99
10 1 8 1
12 1 9 1
5
9 6 3 8
6 2 3 8
8 2 3 8
10 2 3 8
12 2 3 8
1
0 13 0 14 3 main 28 -3
0
	monster(n[x,y,dif])		item(n[x,y,id,count])id=2(coins)		doors(n[dX,dY,id,tex])		plate(n[x,y,x2,y2acID,acVal]) -1 стандарт, -2 пред х -3 пред у