30 20
2 2
111111111111111111111111111111
100000000000000000000000000001
100000000000000000000000000001
100000000000000000000000000001
100000000000000000000000000001
100000000000000000000000000001
100000000000000000000000000001
100000000000000000000000000001
100000000000000000000000000001
100000000000000000000000000001
100000000000000000000000000001
100011101111111111111111111111
111155555555555555555555535551
555555555555555555555555535551
555555555555555555555555535551
111155555555555555555555535551
100011111151111111111111111111
100000000555000000000000000001
100000005555500000000000000001
111111111111111111111110111111
0
0
0
0
	monster(n[x,y,dif])		item(n[x,y,id,count])id=2(coins)		doors(n[dX,dY,id,tex])		plate(n[x,y,x2,y2acID,acVal]) -1 стандарт, -2 пред х -3 пред у