30 35
2 2
111111111111111111111111111111
100000100000000000000000000001
100000101000000000000000000001
111110111000000000000000000001
100000000000000000000000000001
144444444444434444444444444441
122222222222232222222222222221
122222222222232222222222222221
144444444444434444444444444441
100000000000000000000000000001
100000001000100000000000000001
100000000111000000000000000001
100000000000000000000000000001
555555555555555555555555535555
555555555555555555555555535555
100000555550000000000000000001
110110055500000000000000000001
100010055500000000000000000001
100010055500000000000000000001
111111155511111111111110111111
166666655566666666666666666661
166666655566666666666666666661
166666655566666666666666666661
166666655566666666666666666661
166666655566666666666666666661
166666555566666666666666666661
166666555666666666666666666661
166666555666666666666666666661
166666555666666666666666666661
166666555666666666666666666661
166666555666666666666666666661
166665555666666666666666666661
166665556666687866666666666661
166665556666887886666666666661
888885558888887888888888888888
6
4 2 1
5 8 1
0 0 50
13 6 1
2 16 5
14 32 15
8
10 18 2 10
15 18 1 5
7 2 0 1
2 2 3 2
8 8 4 1
2 18 2 75
1 22 2 50
19 32 5 1
3
13 7 3 8
23 19 3 8
2 18 5 10
23
1 4 0 0
1 4 0 1
1 1 1 5
1 1 2 2
23 19 1 5
23 19 2 2
9 19 1 5
9 19 2 2
8 19 1 5
8 19 2 2
7 19 1 5
7 19 2 2
23 20 1 25
23 20 2 6
9 20 1 25
9 20 2 6
8 20 1 25
8 20 2 6
7 20 1 25
7 20 2 6
14 34 1 1
14 34 2 15
14 34 3 cave 14 1
	monster(n[x,y,dif])		item(n[x,y,id,count])id=2(coins)		doors(n[dX,dY,id,tex])		plate(n[x,y,acID,acVal])