30
20
2
2
111111111111111111111111111111
100000100000000000000000000001
100000101000000000000000000001
100000111000000000000000000001
100000000000000000000000000001
100000000000000000000000000001
122222222222232222222222222221
122222222222232222222222222221
100000000101000000000000000001
100000000000000000000000000001
100000001000100000000000000001
100000000111000000000000000001
100000000000000000000000000001
100000000000000000000000000001
100000000000000000000000000001
100000000000000000000000000001
100000000000000000000000000001
100000000000000000000000000001
100000000000000000000000000001
111111111111111111111111111111



10001
10001
11111









111111111111111111
1
1
1
1
1
1
1
1000000000000000
111111111111111111