30 35
2 9
111115551111110111111111111111
100000000000010100000000000001
100010101000010100000000000001
100010100000000000000000000001
100000000000000000000000000001
100000000000000000000000000001
100000000000000000000000000001
100000000000000000000000000001
100000000000000000000000000001
100000000000000000000000000001
100000001000100000000000000001
100000000111000000000000000001
100000000000000000000000000001
100000000000000000000000000001
100000000000000000000000000001
100000000000000000000000000001
110110000000000000000000000001
100010000000000000000000000001
100010000000000000000000000001
100000000000000000000000000001
100000000000000000000000000001
100000000000000000000000000001
100000000000000000000000000001
100000000000000000000000000001
100000000000000000000000000001
100000000000000000000000000001
100000000000000000000000000001
100000000000000000000000000001
100000000000000000000000000001
100000000000000000000000000001
100000000000000000000000000001
100000000000000000000000000001
100000000000000000000000000001
100000000000000000000000000001
111111111111111111111111111111
0
0
1
2 2 3 8
1
14 0 14 0 3 main 14 33
	monster(n[x,y,dif])		item(n[x,y,id,count])id=2(coins)		doors(n[dX,dY,id,tex])		plate(n[x,y,x2,y2acID,acVal]) -1 стандарт, -2 пред х -3 пред у