8 8 8 8 8 5 5 5 8 8 8 8 8 8 7 8 8 8 8 8 8 8 8 8 8 8 8 8 8 8
8 7 7 7 8 5 5 5 8 8 7 7 7 8 7 8 7 7 7 7 7 7 7 7 7 7 7 8 7 8
8 7 7 7 8 5 5 5 8 8 7 8 7 8 7 8 7 8 8 8 8 8 7 8 8 8 7 8 7 8
8 7 7 7 8 5 5 5 8 8 7 8 7 7 7 8 7 7 7 7 7 8 7 7 7 8 7 7 7 8
8 8 7 8 8 5 5 5 8 8 7 8 7 8 7 8 7 8 8 8 7 8 8 8 7 8 8 8 8 8
8 8 7 8 5 5 5 8 8 8 7 8 7 8 7 7 7 8 7 7 7 8 7 7 7 7 7 7 7 8
8 7 7 8 5 5 8 8 8 8 7 8 7 8 8 8 8 8 8 8 7 8 7 8 8 8 8 8 7 8
8 7 7 8 5 5 8 8 8 7 7 8 7 7 7 7 7 7 7 8 7 8 7 7 7 8 7 7 7 8
8 7 7 8 5 5 5 8 8 8 7 8 8 8 8 8 8 8 7 8 8 8 7 8 8 8 8 8 8 8
8 8 7 8 5 5 5 5 8 8 7 7 7 7 7 8 7 8 7 8 7 7 7 7 7 8 7 7 7 8
8 5 3 5 5 5 5 5 8 8 8 8 7 8 7 8 7 8 8 8 7 8 8 8 8 8 7 8 7 8
8 5 3 5 5 5 5 8 8 8 7 7 7 8 7 8 7 7 7 8 7 7 7 8 7 7 7 8 7 8
8 8 7 8 8 8 8 8 8 8 7 8 7 8 7 8 8 8 7 8 7 8 8 8 7 8 8 8 7 8
8 8 7 7 7 8 7 7 7 7 7 8 7 8 7 7 7 7 7 8 7 7 7 7 7 8 7 8 7 8
8 8 7 8 7 8 7 8 8 8 7 8 8 8 8 8 8 8 8 8 8 8 8 8 8 8 7 8 7 8
8 8 7 8 7 8 7 7 7 8 7 7 7 8 7 7 7 7 7 7 7 7 7 7 7 8 7 7 7 8
8 8 8 8 7 8 7 8 8 8 8 8 7 8 7 8 8 8 8 8 7 8 8 8 7 8 8 8 8 8
8 8 7 7 7 8 7 7 7 7 7 8 7 7 7 8 7 7 7 8 7 8 7 8 7 7 7 7 7 8
8 8 7 8 8 8 8 8 7 8 8 8 8 8 8 8 7 8 8 8 7 8 7 8 7 8 8 8 7 8
8 8 7 7 7 8 7 8 7 7 7 7 7 7 7 8 7 8 7 7 7 8 7 7 7 8 7 8 7 8
8 8 7 8 7 8 7 8 8 8 7 8 7 8 8 8 7 8 7 8 8 8 8 8 8 8 7 8 7 8
8 8 7 8 7 7 7 7 7 8 7 8 7 8 7 7 7 8 7 7 7 7 7 7 7 8 7 7 7 8
8 8 7 8 8 8 8 8 8 8 7 8 7 8 7 8 8 8 7 8 8 8 8 8 7 8 8 8 8 8
8 8 7 7 7 8 7 7 7 7 7 8 7 8 7 7 7 8 7 7 7 8 7 7 7 8 7 7 7 8
8 8 7 8 7 8 7 8 8 8 8 8 7 8 7 8 8 8 8 8 7 8 7 8 8 8 7 8 7 8
8 8 7 8 7 8 7 8 7 7 7 7 7 8 7 7 7 7 7 8 7 8 7 7 7 8 7 8 7 8
8 8 8 8 7 8 7 8 7 8 8 8 8 8 8 8 7 8 8 8 7 8 8 8 7 8 7 8 7 8
8 8 7 7 7 8 7 8 7 7 7 8 7 7 6 8 7 7 7 7 7 7 7 8 7 7 7 8 7 8
8 8 7 8 8 8 7 8 8 8 8 8 7 8 8 8 8 8 8 8 8 8 7 8 8 8 8 8 7 8
8 8 7 7 7 8 7 7 7 7 7 8 7 7 7 7 7 7 7 7 7 8 7 7 7 8 7 7 7 8
8 8 7 8 7 8 8 8 8 8 7 8 8 8 7 8 8 8 8 8 7 8 7 8 8 8 7 8 8 8
8 8 7 8 7 7 7 7 7 8 7 7 7 7 7 7 7 7 7 8 7 8 7 7 7 8 7 7 7 8
8 8 7 8 8 8 7 8 8 8 8 8 8 8 8 8 8 8 8 8 7 8 8 8 7 8 8 8 8 8
8 8 7 7 7 8 7 7 7 7 7 7 7 7 7 7 7 7 7 7 7 7 7 8 7 7 7 7 7 8
8 8 8 8 8 8 8 8 8 8 8 8 8 8 8 8 8 8 8 8 8 8 8 8 8 8 8 8 8 8