30 35
2 2
111111111111111111111111111111
100000100000000000000000000001
100000101000000000000000000001
100000000000000000000000000001
100000000000000000000000000001
144444444444434444444444444441
122222222222232222222222222221
122222222222232222222222222221
144444444444434444444444444441
100000000000000000000000000001
100000001000100000000000000001
100000000111000000000000000001
100000000000000000000000000001
100000000000000000000000000001
100000000000000005555555555551
100000000000000005000000000001
110110000000000005000000000001
100010000000000000000000000001
100010000000000005000000000001
111111111111111111111110111111
166666666666666666666666666661
166666666666666666666666666661
166666666666666666666666666661
166666666666666666666666666661
166666666666666666666666666661
166666666666666666666666666661
166666666666666666666666666661
166666666666666666666666666661
166666666666666666666666666661
166666666666666666666666666661
166666666666666666666666666661
166666666666666666666666666661
166666666666666666666666666661
166666666666666666666666666661
111111111111111111111111111111
0
0
0
	monster(n[x,y,dif])		item(n[x,y,id,count])id=2(coins)		plate(n[x,y,acID,acVal])