30 20
2 2
111111111111111111111111111111
100000100000000000000000000001
100000101000000000000000000001
111110111000000000000000000001
100000000000000000000000000001
144444444444434444444444444441
122222222222232222222222222221
122222222222232222222222222221
144444444444434444444444444441
100000000000000000000000000001
100000001000100000000000000001
100000000111000000000000000001
100000000000000000000000000001
100000000000000000000000000001
100000000000000005555555555551
100000000000000005000000000001
100000000000000005000000000001
100000000000000000000000000001
100000000000000005000000000001
111111111111111111111111111111
4
4 2
5 8
0 0
13 6
	monster(n[x,y])		item(n[id,count,x,y])	
6
2 1 10 18
1 1 15 18
0 2 7 2
1 0 2 2
3 1 2 2
4 1 8 8