111111111111111111111111111111
100000100000000000000000000001
100000101000000000000000000001
111110111000000000000000000001
100000000000000000000000000001
144444444444434444444444444441
122222222222232222222222222221
122222222222232222222222002221
144444444444434444422222222221
100000000000000000444444444441
100000000000000000000000000001
100000000000000000000000000001
100000000000000000000000000001
553555555555555555535555555555
553555555555555555535555555555
100000555550000000000000000001
110110055500000000000000000001
100010055500000000000000000001
100010055500000000000000000001
111111155511111111101111111111
166666655566666666666666666661
166666655566666666666666666661
166666655566666666666666666661
166666655566666666666666666661
166666655566666666666666666661
166666555566666666666666666661
166666555666666666666666666661
166666555666666666666666666661
166666555666666666666666666661
166666555666666666666666666661
166666555666666666666666666661
166665555666666666666666666661
166665556666687866666666666661
166665556666887886666666666661
888885558888887888888888888888


<REMOVED>
5
4 2 1
19 17 5
13 6 1
2 16 5
14 32 15
9
19 17 3 1
1 2 10 1
10 18 2 3
25 7 1 5
7 2 0 1
2 2 3 1
2 18 2 75
1 22 2 50
19 32 5 1
3
13 7 3 8
19 19 3 8
2 18 5 10
12
1 4 1 5 0 0
1 4 1 5 0 1
1 1 1 1 1 5
1 1 1 1 2 2
0 19 40 19 1 5
0 19 40 19 2 2
0 20 40 20 1 25
0 20 40 20 2 6
0 34 40 34 1 10
0 34 40 34 2 10
0 34 40 34 3 cave -2 1
29 13 29 14 3 secret -1 -3
1
28 1 14 1 0 -1 50
5 5 14 2 6 -1 10 7 1 100
	monster(n[x,y,dif])		item(n[x,y,id,count])id=2(coins)		doors(n[dX,dY,id,tex])
	plate(n[x,y,x2,y2acID,acVal]) -1 стандарт, -2 пред х -3 пред у		shop(n[x,y,tex,itemCount[id,count,cost]])