111115551111110111111111111111
100015551100010100000000000101
100015551101010101111101110101
100015551101000100000100010001
110115551101010101110111011111
110155511101010001000100000001
100155111101011111110101111101
100155111001000000010100010001
100155511101111111011101111111
110155551100000101010000010001
153555551111010101110111110101
153555511100010100010001000101
110111111101010111010111011101
110001000001010000010000010101
110101011101111111111111110101
110101000100010000000000010001
111101011111010111110111011111
110001000001000100010101000001
110111110111111101110101011101
110001010000000101000100010101
110101011101011101011111110101
110100000101010001000000010001
110111111101010111011111011111
110001000001010001000100010001
110101011111010111110101110101
110101010000010000010100010101
111101010111111101110111010101
110001010001006100000001000101
110111011111011111111101111101
110001000001000000000100010001
110101111101110111110101110111
110100000100000000010100010001
110111011111111111110111011111
110001000000000000000001000001
111111111111111111111111111111
0
3
26 13 4 1
1 1 11 1
2 2 2 1000
2
13 27 4 8
2 2 11 10
4
0 0 40 0 1 25
0 0 40 0 2 6
0 0 40 0 3 main -2 33
14 27 14 27 3 cave2 1 1
0
	monster(n[x,y,dif])		item(n[x,y,id,count])id=2(coins)		doors(n[dX,dY,id,tex])		plate(n[x,y,x2,y2acID,acVal]) -1 стандарт, -2 пред х -3 пред у